#####################################################################################################
#                                                                                                   #
#                                                                                                   #
#                                                                                                   #
#                                                                                                   #
#                                                                                                   #
#                                                                                                   #
#                                                                                                   #
#                                                                                                   #
#                                                                                                   #
#                                                                                                   #
#                                                                                                   #
#                                                                                                   #
#                                                                                                   #
#                                                                                                   #
#                                                                                                   #
#                                                                                                   #
#                                                                                                   #
#                                                                                                   #
#                                                                                                   #
#                                                                                                   #
#                                                                                                   #
#                                                                                                   #
#                                                                                                   #
#                                                                                                   #
#                                                                                                   #
#                                                                                                   #
#                                                                                                   #
#                                                                                                   #
#                                                                                                   #
#                                                                                                   #
#                                                                                                   #
#                                                                                                   #
#                                                                                                   #
#                                                                                                   #
#                                                                                                   #
#                                                                                                   #
#                                                                                                   #
#                                                                                                   #
#                                                                                                   #
#                                                                                                   #
#                                                                                                   #
#                                                                                                   #
#                                                                                                   #
#                                                                                                   #
#                                                                                                   #
#                                                                                                   #
#                                                                                                   #
#                                                                                                   #
#                                                                                                   #
#                                                                                                   #
#                                                                                                   #
#                                                                                                   #
#                                                                                                   #
#                                                                                                   #
#                                                                                                   #
#                                                                                                   #
#                                                                                                   #
#                                                                                                   #
#                                                                                                   #
#                                                                                                   #
#                                                                                                   #
#                                                                                                   #
#                                                                                                   #
#                                                                                                   #
#                                                                                                   #
#                                                                                                   #
#                                                                                                   #
#                                                                                                   #
#                                                                                                   #
#                                                                                                   #
#                                                                                                   #
#                                                                                                   #
#                                                                                                   #
#                                                                                                   #
#                                                                                                   #
#                                                                                                   #
#                                                                                                   #
#                                                                                                   #
#                                                                                                   #
#                                                                                                   #
#                                                                                                   #
#                                                                                                   #
#                                                                                                   #
#                                                                                                   #
#                                                                                                   #
#                                                                                                   #
#                                                                                                   #
#                                                                                                   #
#                                                                                                   #
#                                                                                                   #
#                                                                                                   #
#                                                                                                   #
#                                                                                                   #
#                                                                                                   #
#                                                                                                   #
#                                                                                                   #
#                                                                                                   #
#                                                                                                   #
#                                                                                                   #
#####################################################################################################